##########
#......R.#
#@.....>.#
#......R.#
##########