##########
#...r..R.#
#@.....>.#
#......R.#
##########