#########
#......R#
#@.....>#
#......R#
#########