#########
#......R#
#@.....>#
#..r...R#
#########